teren.png
0,0,0 0,0,0 0,0,0 0,0,0 0,0,0 0,0,0 0,0,0 0,0,0 0,0,0 0,0,0 0,0,0 0,0,0 0,0,0 0,0,0 0,0,0 0,0,0 0,0,0 0,0,0 0,0,0 0,0,0 0,0,0 0,0,0 0,0,0 0,0,0 0,0,0 0,0,0 0,0,0 0,0,0 0,0,0 0,0,0
0,0,0 0,1,1 1,1,1 2,1,1 1,3,1 1,3,1 2,1,1 1,1,1 1,1,1 1,1,1 1,1,1 1,1,1 1,1,1 1,1,1 1,1,1 1,1,1 1,1,1 1,1,1 1,1,1 1,1,1 1,1,1 1,1,1 1,1,1 1,1,1 1,1,1 1,1,1 1,1,1 1,1,1 1,1,1 0,0,0
0,0,0 0,2,1 1,2,0 1,2,0 1,2,4 1,2,0 2,1,1 2,1,1 1,2,0 1,2,0 1,2,0 1,2,0 1,2,0 1,2,0 1,2,0 1,2,0 1,2,0 1,2,0 1,1,1 1,1,1 1,2,0 1,2,0 1,2,0 1,2,0 1,1,1 1,1,1 1,2,2 1,2,2 1,1,1 0,0,0
0,0,0 0,2,1 1,2,0 1,2,0 1,2,0 1,2,0 2,1,1 2,1,1 1,2,0 1,2,0 1,2,0 1,2,0 1,2,0 1,2,0 1,2,0 1,2,0 1,2,0 1,2,0 1,1,1 1,1,1 1,2,0 1,2,0 1,2,0 1,2,0 1,1,1 1,1,1 1,2,2 1,2,2 1,1,1 0,0,0
0,0,0 0,2,1 1,2,0 1,2,0 1,2,3 1,2,0 2,1,1 2,1,1 1,2,0 1,2,0 1,1,1 1,1,1 1,1,1 1,1,1 1,1,1 1,1,1 1,2,0 1,2,0 1,1,1 1,1,1 1,2,0 1,2,0 1,1,1 1,1,1 1,1,1 1,1,1 1,2,2 1,2,2 1,1,1 0,0,0
0,0,0 0,2,1 1,2,2 1,2,2 1,2,2 1,2,2 2,1,1 2,1,1 1,2,0 1,2,0 1,1,1 1,1,1 1,1,1 1,1,1 1,1,1 1,1,1 1,2,0 1,2,0 1,1,1 1,1,1 1,2,0 1,2,0 1,1,1 1,1,1 1,1,1 1,1,1 1,1,1 1,1,5 1,1,1 0,0,0
0,0,0 1,1,1 1,1,1 1,1,1 1,2,0 1,2,0 1,1,1 1,1,1 1,2,0 1,2,0 1,1,1 1,1,1 1,2,0 1,2,4 1,2,0 1,2,0 1,2,0 1,2,0 1,1,1 1,1,1 1,2,0 1,2,0 1,2,0 1,2,0 1,2,0 1,2,0 1,2,0 1,2,0 1,1,1 0,0,0
0,0,0 1,1,1 1,1,1 1,1,1 1,2,0 1,2,0 1,1,1 1,1,1 1,2,0 1,2,0 1,1,1 1,1,1 1,2,2 1,2,4 1,2,0 1,2,0 1,2,0 1,2,0 1,1,1 1,1,1 1,2,0 1,2,0 1,2,0 1,2,0 1,2,0 1,2,0 1,2,0 1,2,0 1,1,1 0,0,0
0,0,0 0,2,1 1,2,0 1,2,0 1,2,0 1,2,0 1,1,1 1,1,1 1,2,0 1,2,0 1,1,1 1,1,1 1,1,1 1,1,1 1,1,1 1,1,1 1,1,1 1,1,1 1,1,1 1,1,1 1,1,1 1,1,1 1,2,0 1,2,0 1,1,1 1,1,1 1,1,1 1,1,1 1,1,1 0,0,0
0,0,0 0,2,1 1,2,0 1,2,0 1,2,0 1,2,4 1,1,1 1,1,1 1,2,0 1,2,0 1,1,1 1,1,1 1,1,1 1,1,1 1,1,1 1,1,1 1,1,1 1,1,1 1,1,1 1,1,1 1,1,1 1,1,1 1,2,0 1,2,0 1,1,1 1,1,1 1,1,1 1,1,1 1,1,1 0,0,0
0,0,0 0,2,1 1,2,0 1,2,0 1,1,1 1,1,1 1,1,1 1,1,1 1,2,0 1,2,0 1,1,1 1,1,1 1,2,0 1,2,0 1,2,0 1,2,0 1,2,0 1,2,0 1,2,0 1,2,0 1,2,0 1,2,0 1,2,0 1,2,0 1,1,1 1,1,1 1,2,2 1,2,3 1,1,1 0,0,0
0,0,0 0,2,1 1,2,0 1,2,0 1,1,1 1,1,1 1,1,1 1,1,1 1,2,0 1,2,0 1,1,1 1,1,1 1,2,0 1,2,0 1,2,0 1,2,0 1,2,0 1,2,0 1,2,0 1,2,0 1,2,0 1,2,0 1,2,0 1,2,0 1,1,1 1,1,1 1,2,0 1,2,0 1,1,1 0,0,0
0,0,0 0,2,1 1,2,0 1,2,0 1,2,0 1,2,0 1,2,0 1,2,0 1,2,0 1,2,0 1,2,0 1,2,0 1,2,0 1,2,0 1,1,1 1,1,1 1,2,0 1,1,1 1,1,1 1,1,1 1,1,1 1,1,1 1,1,1 1,1,1 1,1,1 1,1,1 1,2,4 1,2,4 1,1,1 0,0,0
0,0,0 0,2,1 1,2,0 1,2,0 1,2,0 1,2,0 1,2,0 1,2,0 1,2,0 1,2,0 1,2,4 1,2,0 1,2,0 1,2,0 1,1,1 1,1,1 1,2,0 1,1,1 1,1,1 1,1,1 1,1,1 1,1,1 1,1,1 1,1,1 1,1,1 1,1,1 1,2,0 1,2,0 1,1,1 0,0,0
0,0,0 0,2,1 1,2,0 1,1,1 1,1,1 1,1,1 1,1,1 1,1,1 1,1,1 1,1,1 1,1,1 1,1,1 1,2,0 1,2,0 1,1,1 1,1,1 1,2,0 1,1,1 1,2,0 1,2,0 1,2,0 1,2,0 1,2,0 1,1,1 1,2,0 1,2,0 1,2,0 1,2,0 1,1,1 0,0,0
0,0,0 0,2,1 1,2,0 1,1,1 1,1,1 1,1,1 1,1,1 1,1,1 1,1,1 1,1,1 1,1,1 1,1,1 1,2,0 1,2,0 1,1,1 1,1,1 1,2,0 1,1,1 1,2,0 1,1,1 1,1,1 1,1,1 1,2,0 1,1,1 1,1,1 1,2,0 1,2,0 1,2,0 1,1,1 0,0,0
0,0,0 0,2,1 1,2,0 1,2,0 1,2,0 1,1,1 1,2,0 1,2,2 1,1,1 1,1,1 1,2,2 1,1,1 1,2,0 1,2,0 1,1,1 1,1,1 1,2,4 1,1,1 1,2,0 1,2,0 1,2,0 1,1,1 1,2,0 1,1,1 1,2,0 1,2,0 1,1,1 1,2,0 1,1,1 0,0,0
0,0,0 0,2,1 1,2,0 1,1,1 1,1,1 1,1,1 1,2,0 1,1,1 1,1,1 1,1,1 1,2,0 1,2,4 1,2,0 1,2,0 1,1,1 1,1,1 1,2,0 1,1,1 1,1,1 1,1,1 1,2,0 1,1,1 1,2,0 1,2,0 1,2,0 1,2,0 1,1,1 1,2,0 1,1,1 0,0,0
0,0,0 0,2,1 1,2,0 1,1,1 1,2,0 1,2,0 1,2,0 1,2,2 1,1,1 1,1,1 1,1,1 1,1,1 1,1,1 1,1,1 1,1,1 1,1,1 1,2,0 1,2,0 1,2,0 1,2,0 1,2,0 1,1,1 1,1,1 1,2,0 1,1,1 1,1,1 1,1,1 1,2,0 1,1,1 0,0,0
0,0,0 0,2,1 1,2,0 1,1,1 1,2,0 1,1,1 1,1,1 1,1,1 1,1,1 1,1,1 1,1,1 1,1,1 1,1,1 1,1,1 1,1,1 1,1,1 1,2,0 1,2,0 1,2,0 1,2,0 1,2,0 1,1,1 1,1,1 1,2,0 1,1,1 1,2,0 1,2,0 1,2,0 1,1,1 0,0,0
0,0,0 0,2,1 1,2,0 1,1,1 1,2,0 1,1,1 1,2,2 1,1,1 1,2,3 1,1,1 1,2,0 1,2,0 1,2,0 1,1,1 1,2,0 1,2,0 1,2,0 1,1,1 1,1,1 1,1,1 1,1,1 1,1,1 1,2,0 1,2,0 1,1,1 1,1,1 1,1,1 1,1,1 1,1,1 0,0,0
0,0,0 0,2,1 1,2,0 1,2,0 1,2,0 1,2,0 1,2,0 1,1,1 1,2,0 1,2,0 1,2,6 1,1,1 1,2,0 1,2,4 1,2,0 1,1,1 1,2,0 1,1,1 1,2,0 1,2,0 1,2,0 1,2,0 1,2,0 1,2,0 1,2,0 1,2,4 1,2,0 1,2,2 1,1,1 0,0,0
0,0,0 1,1,1 1,1,1 1,1,1 1,1,1 1,1,1 1,1,1 1,1,1 1,1,1 1,1,1 1,1,1 1,1,1 1,1,1 1,1,1 1,1,1 1,1,1 1,1,1 1,1,1 1,1,1 1,1,1 1,1,1 1,1,1 1,1,1 1,1,1 1,1,1 1,1,1 1,1,1 1,1,1 1,1,1 0,0,0
0,0,0 0,0,0 0,0,0 0,0,0 0,0,0 0,0,0 0,0,0 0,0,0 0,0,0 0,0,0 0,0,0 0,0,0 0,0,0 0,0,0 0,0,0 0,0,0 0,0,0 0,0,0 0,0,0 0,0,0 0,0,0 0,0,0 0,0,0 0,0,0 0,0,0 0,0,0 0,0,0 0,0,0 0,0,0 0,0,0